{
    "9": 200,
    "19": 200,
    "8": 200,
    "31": 250,
    "7": 140,
    "22": 170,
    "18": 170,
    "25": 170,
    "17": 170,
    "26": 170,
    "11": 120,
    "21": 120,
    "28": 120,
    "24": 120,
    "30": 120,
    "10": 120,
    "29": 120,
    "27": 120,
    "23": 120
  }
  